11111111111
100C00010E1
100C0001001
10010001001
10010001001
1001000C001
1P01000C001
11111111111
