11111111111111111111
1CCCCCCCCCCCCCCCCC11
100000001E0000000011
10000000100000000011
1000C000100000100011
100010000C0100000011
10001000000P100C0011
11111111111111111111