1111111111111
1E110000000C1
1000010111001
1P00110000001
1111111111111