111111111111111111111111111111111111111111
100000000CCCCCC0000111111C0000100000000001
100000C001101010000100001000001000C0000001
1E0000100000001000010001111000111100000001
1P00001C000000100001000000100M000000111001
1111000000100000C000001110100000100010C001
10C001000010000M00000001000000001000100001
111111111111111111111111111111111111111111
