1111111111111111111111
100M000000000000000001
100000000000000C000001
1000000P00000000M00001
1000000000000000000001
10M0000000C0000M000001
1000000000000000000001
10000C000000000M000001
10M0000000000000000001
1000C00C0000000M0000E1
1111111111111111111111
